а - а
b - б
v - в
g - г
d - д
e - е
e - ё
zh - ж
z - з
i - и
y - й
k - к
l - л
m - м
n - н
o - о
p - п
r - р
s - с
t - т
u - у
f - ф
kh - х
ts - ц
ch - ч
sh - ш
shch - щ
y - ы
e - э
yu - ю
ya - я
A - А
B - Б
V - В
G - Г
D - Д
E - Е
E - Ё
ZH - Ж
Z - З
I - И
Y - Й
K - К
L - Л
M - М
N - Н
O - О
P - П
R - Р
S - С
T - Т
U - У
F - Ф
KH - Х
TS - Ц
CH - Ч
SH - Ш
SHCH - Щ
Y - Ы
E - Э
YU - Ю
YA - Я
